1111111111111
1...........1
1..1.....1..1
1..1.....1..1
1...........1
1..1.....1..1
1..1.....1..1
1...........1
1..1.....1..1
1..1.....1..1
1....A......1
1..1.B...1..1
1..1.C...1..1
1...........1
1..1.....1..1
1..1.....1..1
1...........1
1..1.....1..1
1..1.....1..1
1...........1
1..1.....1..1
1..1.....1..1
1...........1
1.....P.....1
1111111111111